150 100 100 100 100 100 200 100 100 100 200 200 200 
200 110 110 110 110 110 110 110 110 110 110 200 200 
100 100 200 100 100 300 100 100 110 110 100 100 301 
100 200 100 100 100 100 100 110 110 100 300 100 100 
100 100 200 200 200 200 110 110 100 100 100 100 100 
200 301 100 100 100 110 110 100 300 100 200 100 100 
100 100 100 100 110 110 200 200 110 110 200 110 110 
100 200 100 110 110 100 100 200 110 100 200 100 110 
100 100 110 110 100 300 100 100 110 100 110 100 110 
200 110 110 110 110 110 110 110 110 110 110 200 200 
200 100 301 100 100 200 100 100 300 100 100 200 999