150 100 100 100 100 100 200 110 110 110 110 100 100 
100 100 200 110 110 110 200 100 100 200 300 100 200 
100 300 200 200 200 100 110 110 200 100 100 200 100 
110 200 100 300 200 100 200 110 200 110 110 110 100 
110 200 110 110 110 100 200 100 200 200 200 200 200 
110 200 100 200 100 100 100 110 100 100 300 110 200 
110 200 200 100 200 100 200 100 110 100 100 110 200 
110 200 200 100 110 100 110 100 100 110 100 100 100 
999 110 100 100 100 300 100 200 100 110 300 100 100 
200 110 300 110 100 110 100 100 110 200 200 110 100 
200 200 200 300 200 100 100 100 110 200 200 200 110