150 100 100 200 110 110 110 110 110 200 100 100 302 
100 100 200 200 200 100 302 100 200 200 200 100 100 
200 200 200 110 110 110 110 110 200 110 200 200 200 
100 110 100 110 200 200 200 200 302 110 100 110 100 
100 110 100 110 100 110 110 110 100 110 100 110 100 
302 110 200 110 100 110 999 110 100 110 200 110 302 
100 110 100 110 100 110 200 110 100 110 100 110 100 
100 110 100 110 302 200 200 200 200 110 100 110 100 
200 200 200 110 200 110 110 110 110 110 200 200 200 
100 100 200 200 200 100 302 100 200 200 200 100 100 
302 100 100 200 110 110 110 110 110 200 100 100 302